Pages needing documentation created:

backcrossing-services: Backcrossing Services
cystic-fibrosis-mice: Cystic Fibrosis Mouse Models
h11-safe-harbor: H11 Safe Harbor Locus
antibody-therapeutics-mouse-models: Antibody Therapeutics Mouse Models
depression-anxiety-mouse-models: Depression and Anxiety Mouse Models
hypertension-mouse-models: Hypertension Mouse Models
knockin-rat-models: Knockin Rat Models
gfp-knockin-mice: GFP Knockin Mice
hprt-locus-targeting: HPRT Locus Targeting
epilepsy-mouse-models: Epilepsy Mouse Models
cell-therapy-mouse-models: Cell Therapy Mouse Models
rheumatoid-arthritis-mice: Rheumatoid Arthritis Mouse Models
flag-tag-knockin: FLAG Tag Knockin Mice
rapid-rosa26-targeting: Rapid Rosa26 Targeting
lacz-knockin-mice: LacZ Knockin Mice
huntingtons-mouse-models: Huntington Disease Mouse Models
target-validation-mouse-models: Target Validation Mouse Models
video-library: Video Library
lineage-tracing-mouse-models: Lineage Tracing Mouse Models
cardiac-fibrosis-mice: Cardiac Fibrosis Mouse Models
gene-function-studies: Gene Function Studies
knockout-rat-models: Knockout Rat Models
c57bl6j-vs-c57bl6n: C57BL/6J vs C57BL/6N Comparison
mouse-strain-backgrounds: Mouse Strain Backgrounds
knockout-first-allele: Knockout First Allele
transgenic-rat-models: Transgenic Rat Models
selection-cassette-design: Selection Cassette Design
reporter-selection-guide: Reporter Selection Guide
humanization-strategy-guide: Humanization Strategy Guide
efficacy-testing-mouse-models: Efficacy Testing Mouse Models
type-2-diabetes-mice: Type 2 Diabetes Mouse Models
pathway-analysis-mice: Pathway Analysis Mouse Models
strain-selection-guide: Strain Selection Guide
gene-therapy-mouse-models: Gene Therapy Mouse Models
model-generation-timeline: Model Generation Timeline
autism-mouse-models: Autism Mouse Models
safe-harbor-locus: Safe Harbor Locus
fast-mice: FAST Mice
research-applications: Research Applications
inflammatory-disease-mice: Inflammatory Disease Mouse Models
knockout-strategy-guide: Knockout Strategy Guide
type-1-diabetes-mice: Type 1 Diabetes Mouse Models
biomarker-discovery-mice: Biomarker Discovery Mouse Models
ha-tag-knockin: HA Tag Knockin Mice
tdtomato-knockin-mice: tdTomato Knockin Mice
